z+
#.#######################
#....   ................#
#....   ..E...   .. ....#
#.E................ ....#
#....   ........ .......#
#.........E..... ..E. ..#
########O######.........#
#.E.......#III#.... . ..#
#####.##.##O####.#......#
#.E.#.......I.#......   #
#.E. .....I...#####. . ..
#.E.#....I.I..#E....  ..#
#########################
z-

E: 0, 0, 0, 0, 1
I: ring, book, 3
E: 0, 0, 0, 0
I: pot, ring, 1, 0

/check 'F.txt' file for read about 'E', 'z+', ... 
