z+
################################
#I....I#....   ..#.............#
#..I...#.........#........E. ..#
#.E.E..O. .. .... .............#
#......#.........#.......... ..#
#########.#####.####.#.........#
#..........#.........#.........#
...    ....#.........#####.#####
# .    ....#.........#E.........
################################
z-

E: 0, 0, 0
I: 0, 1, 0

/check 'F.txt' file for read about 'E', 'z+', ... 
