z+
##############################
#K.......I..   ..#...........#
#....E. .........#........ ..#
#....E. ....E....#........ ..#
#....E. . .. .... ......E....#
#K...............#........ ..#
#########.#####.####.#.E..E..#
#.EE.......#.........#.......#
...    ..I.#.##.  ...###.#####
# .    . ..#I ... ...#E.......
##############################
z-

E: 0, 1, 0, 0, 0, 1, 1, 1, 1, 0
I: pot, pot, 2

/check 'F.txt' file for read about 'E', 'z+', ... 
