z+
####################.####################
#.................#...#.................#
#.................#...#.................#
#....G............#...#.................#
#.................#...#.................#
#.................#.....................#
#.................#...#.................#
#.................#...#.................#
#.................#...#.................#
#.................#...#.................#
#.................#...#.................#
#.................#...#.................#
#.................#...#.................#
#...............###...###...............#
##.##############.......#################
#.......................................O
##.##############.......#################
#...............###...###...............#
#.................#...#.................#
#.................#...#.................#
#.................#...#.................#
#.................#...#.................#
#.................#...#.................#
#.................#...#.................#
#.................#...#.................#
#.................#...#.................#
#.................#.....................#
#...G.............#...#.................#
#.................#...#.................#
#.................#...#.................#
####################.####################
z-
