z+
################################
#I.E...#.........#.............#
#......#....E....#........E. ..#
#......#.........#.............#
#E.E...#.........#.......... ..#
##.######.#####.####.#.........#
#..........#.........#.........#
#...   ....#.........#####.#####
# ... .....#.........#.........#
#..........#.........#.... ..#.#
O. ..E.....#.........#... ......
####...###########.####........#
#....E....#..........#.........#
#.........#..........#.........#
#...I.I..........E...#.E.....E.#
#.........#..........#.... ....#
#....E....#..........#....K....#
###########.####################
z-

/ it's comment 

/E: 0, 0, 0, 0, 0, 0, 0, 0 
E: 1, 0, 0, 1, 1, 1, 1, 0, 0, 0, 0
///I: 2, 1, 2, 3, 0, 0, 0, 1, 1
I: boots, 0, 0

/I: - rarity of Items in the same order as they stay on map

/I mean Item

/E: - type of enemies in the same order as they stay on map

/O is openable door  (you need a key)
/z+ map begin
/z- map end

/C is chest

/K - key (for any O door)
