z+
 ###########.######## 
 #.....#............# 
 #..#.....#...#..#..# 
##.#..#..#..#..##.#.##
#E.#..#E.#.....#E.#.E#
##.#..#..#..####..#.##
 #.E#..#..#.E.#. #..# 
 #I.#..# .#.E.#.....# 
##.#..#..####..#..#.##
#E.#..#E.#..#..#.E#.E#
##.##.#..#..#..#. #.##
 #E.#..#..#. ##..#E.# 
 #.I#..#..#..... #K.# 
 ###########.######## 
z-

E: 1, 1, 1, 1
E: 1, 1, 1
I: 2 
E: 1, 1, 1, 1
E: 1
I: 3